3 0 0 9 88 88 79 0 0 
3 0 0 9 88 79 88 0 0
3 1 0 9 88 88 79 1 0 5 2 2 0 0 32
3 1 0 9 88 88 79 1 0 6 1 1 0 0 32
3 1 0 8 79 88 79 0 0 0 2 2 0 0 88
3 1 0 8 88 88 79 0 0 0 2 0 0 0 79
3 4 0 8 88 79 88 1 0 0 0 0 0 0 79 5 0 2 0 0 32 6 0 1 0 0 32 6 1 2 0 0 32
3 2 0 8 88 88 79 1 0 0 0 0 0 0 79 5 1 1 0 0 32
4 3 0 15 88 88 79 1 0 0 2 2 0 0 79 5 0 0 0 0 32 6 0 1 0 0 32
3 1 0 8 79 79 88 0 0 4 0 2 0 0 88
3 2 0 8 79 79 88 1 0 4 0 2 0 0 88 5 2 2 0 0 32
3 4 0 8 79 88 79 1 0 4 0 2 0 0 88 5 2 0 0 0 32 6 1 0 0 0 32 6 2 1 0 0 32
3 3 0 8 79 79 88 1 0 4 0 2 0 0 88 5 0 0 0 0 32 6 1 0 0 0 32
3 2 0 8 88 79 88 0 0 0 0 2 0 0 79 4 0 2 0 0 79
3 3 0 8 88 79 88 1 0 0 0 0 0 0 79 4 0 0 0 0 79 5 1 2 0 0 32
4 2 0 15 79 79 88 0 0 0 0 0 0 0 88 4 0 0 0 0 88
4 4 0 15 79 79 88 1 0 0 0 0 0 0 88 4 0 0 0 0 88 5 2 1 0 0 32 6 1 1 0 0 32
5 5 0 24 79 79 88 1 0 0 4 4 0 0 88 4 4 4 0 0 88 5 2 2 0 0 32 6 1 1 0 0 32 6 2 3 0 0 32
3 1 0 8 88 88 79 0 0 2 1 1 2 0 50
3 4 0 7 79 88 79 1 0 2 0 0 3 0 51 2 2 2 2 0 50 5 1 2 0 0 32 6 2 1 0 0 32
3 3 0 6 88 88 79 0 0 2 0 1 3 0 51 2 1 2 2 0 50 2 2 1 2 0 50
3 3 0 7 88 88 79 1 0 2 2 2 3 0 51 4 0 0 0 0 79 5 2 2 0 0 51
3 2 0 8 88 88 79 0 0 2 2 1 3 0 51 4 2 1 0 0 51
3 4 0 8 88 88 79 1 0 2 0 2 3 0 51 4 0 2 0 0 51 5 0 1 0 0 32 6 1 2 0 0 32
3 2 0 8 88 88 79 0 0 0 0 0 0 0 51 2 0 0 3 0 51
4 2 0 15 88 88 79 0 0 0 0 0 0 0 50 2 0 0 2 0 50
3 3 0 7 88 88 79 0 0 0 0 0 0 0 54 2 0 0 6 0 54 4 0 0 0 0 54
3 1 0 8 88 79 88 0 1 3 1 1 0 0 84
3 4 0 7 88 79 88 1 1 2 2 2 2 0 50 3 0 0 0 0 84 6 0 2 0 0 32 6 1 0 0 0 32
3 3 0 6 88 79 88 0 1 2 1 0 2 0 50 2 1 2 2 0 50 3 1 1 0 0 84 
3 2 0 7 79 79 88 0 1 4 2 2 0 0 88 3 0 0 0 0 84 
3 4 0 7 79 79 88 1 1 2 2 0 2 0 50 4 0 2 0 0 84 3 0 2 0 0 84 6 1 1 0 0 32
3 2 0 8 88 79 88 0 1 0 0 2 0 0 84 3 0 2 0 0 84
4 3 0 15 88 79 88 1 1 0 3 0 0 0 84 3 3 0 0 0 84 5 0 1 0 0 32
4 5 0 15 88 79 88 1 1 0 3 0 0 0 84 3 3 0 0 0 84 5 0 1 0 0 32 6 1 1 0 0 32 5 0 3 0 0 32 
5 6 0 24 88 79 88 1 1 0 3 0 0 0 84 4 3 0 0 0 84 3 3 0 0 0 84 5 0 1 0 0 32 6 1 1 0 0 32 5 0 3 0 0 32
3 0 1 9 88 88 79 0 0 3 4 4 5 2 4
3 1 1 8 79 88 79 0 0 2 1 0 2 0 50 6 3 2 3 4 4
3 1 1 8 79 79 88 0 1 3 1 1 0 0 84 4 3 1 4 1 3
3 1 1 8 79 79 88 0 0 4 2 2 0 0 88 1 3 5 2 3 4
3 2 1 7 79 79 88 0 1 4 2 0 0 0 88 3 0 2 0 0 84 3 4 3 5 3 2
3 2 1 7 79 79 88 0 0 2 2 0 3 0 51 4 0 2 0 0 88 5 3 3 2 3 6
3 3 1 7 88 79 88 0 1 2 2 2 2 0 50 4 2 2 0 0 50 3 0 0 0 0 84 1 3 4 3 3 2
3 3 1 7 88 79 88 0 1 2 0 0 2 0 50 4 2 2 0 0 84 3 2 2 0 0 84 1 5 3 3 3 3
3 1 1 8 88 79 88 0 0 0 2 2 0 0 79 3 4 2 5 3 1
3 1 0 8 88 88 79 0 0 1 0 0 0 0 79
3 2 0 7 88 88 79 0 0 1 1 2 0 1 79 2 0 1 2 0 50 
3 4 0 6 88 88 79 1 1 2 0 1 2 0 50 1 1 1 0 0 79 3 2 1 0 0 84 6 2 2 0 0 32
3 4 0 6 88 88 79 1 0 1 2 2 0 1 79 4 2 2 0 0 79 5 2 0 0 0 32 6 1 1 0 0 32
3 1 1 8 88 88 79 0 0 1 0 2 0 1 79 4 3 3 4 3 3
3 4 0 7 88 88 79 1 1 2 1 1 2 0 50 1 0 0 0 0 84 3 0 0 0 0 84 5 0 2 0 0 32
3 4 0 7 88 88 79 1 1 1 2 2 0 1 50 2 2 2 2 0 50 3 0 0 0 0 84 6 1 1 0 0 32 
3 5 0 7 79 88 79 1 1 2 0 0 2 0 50 1 2 2 0 1 84 4 2 2 0 0 84 3 2 2 0 0 84 6 1 1 0 0 32
3 2 1 8 79 79 88 0 0 1 0 0 0 0 88 4 0 0 0 0 88 1 3 5 2 3 4
3 0 0 9 88 88 79 0 3
3 3 0 7 88 88 79 1 3 2 0 0 2 0 50 4 2 2 0 0 79 5 0 2 0 0 32
3 3 0 7 88 88 79 0 3 2 0 0 2 0 50 1 2 2 0 1 79 4 2 2 0 0 79
3 1 0 8 88 88 79 0 3 0 0 0 0 0 79
3 3 0 8 88 88 79 1 3 0 0 0 0 0 84 3 0 0 0 0 84 6 1 1 0 0 32
3 6 0 7 88 88 79 1 3 1 0 0 0 0 50 2 0 0 2 0 50 4 0 0 0 0 50 3 1 1 0 0 84 5 0 2 0 0 32 6 0 1 0 0 32
3 2 1 7 79 79 88 0 3 2 2 0 2 0 50 4 0 2 0 0 88 5 3 3 2 3 6
4 5 0 15 79 79 88 1 3 0 2 2 0 0 88 4 2 2 0 0 88 5 2 1 0 0 32 6 1 1 0 0 32 6 1 2 0 0 32
4 1 1 15 79 79 88 0 3 1 3 1 0 0 88 5 5 3 2 5 5 2 3
3 0 0 9 88 32 32 0 0
3 3 0 7 88 32 32 0 3 2 2 2 3 0 51 4 0 0 0 0 84 3 0 0 0 0 84 
3 2 0 8 88 32 32 0 0 2 2 2 3 0 51 4 2 2 0 0 51
3 0 1 9 88 32 32 0 3 5 4 5 5 4 5
3 1 0 8 88 32 32 0 0 1 0 0 0 0 79
3 2 0 8 88 32 32 0 0 1 0 0 0 0 51 2 0 0 3 0 51
3 2 1 7 88 32 32 0 0 2 2 0 3 0 51 4 0 2 0 0 79 4 5 4 5 5 3
3 3 0 8 88 32 32 0 0 1 2 2 0 1 52 2 2 2 4 0 52 4 2 2 0 0 52
4 1 1 15 88 32 32 0 0 1 2 3 0 1 79 6 6 7 5 6 5 7 6
4 3 0 15 88 88 79 1 3 0 2 2 0 0 79 5 0 0 0 0 32 6 0 1 0 0 32
5 3 0 22 79 32 32 0 0 2 0 0 4 0 52 2 0 4 4 0 52 4 4 4 0 0 88
4 6 0 14 79 79 88 1 3 1 0 0 0 0 51 2 0 0 3 0 51 4 0 0 0 0 51 3 3 3 0 0 84 5 3 0 0 0 32 6 0 3 0 0 32
5 6 0 24 79 79 88 1 1 0 4 4 0 0 84 4 4 4 0 0 84 3 4 4 0 0 84 5 2 2 0 0 32 6 1 1 0 0 32 6 2 3 0 0 32
3 1 1 8 79 79 88 0 3 0 1 1 0 0 88 3 2 4 3 1 5 
4 2 1 16 88 32 32 0 0 2 2 3 4 0 52 4 2 3 0 0 52 7 6 6 5 7 6 5 6
4 1 1 15 88 32 32 0 3 1 1 2 0 0 79 5 7 6 5 5 6 7 5   
4 2 1 15 79 79 88 0 0 1 3 0 0 1 88 4 3 0 0 0 88 4 7 4 1 6 4 4 2
5 3 0 24 88 88 79 0 0 0 0 0 0 0 54 2 0 0 6 0 54 4 0 0 0 0 54 
